0 0 0 0 0 0 0 0 0 0 0 0 0 0 0 0 0 0 0 0 0 0 0 0 0 0 0 0 0 0 0 0 0 0 0 0 0 0 0 0 0 0 0 0 0 0 0 0 0 0 0 0 0 0 0 0 0 0 0 0 0 0 0 0 0 0 0 0 0 0 0 0 0
0 1 1 1 1 1 1 1 1 1 1 1 1 1 1 1 1 1 0 0 0 0 0 0 0 0 0 0 0 0 0 0 0 0 0 0 0 0 0 0 0 0 0 0 0 0 1 1 1 1 1 1 1 1 1 1 1 1 1 1 1 1 1 1 1 1 1 1 1 1 1 1 0 
0 1 4 4 4 1 4 4 4 4 4 4 4 4 4 4 4 1 0 0 0 0 0 0 0 0 0 0 0 0 0 0 0 0 0 0 0 0 0 0 0 0 0 0 0 0 1 4 4 4 4 4 4 4 4 1 4 4 4 4 4 4 4 4 4 4 4 4 4 4 4 1 0
0 1 4 4 4 1 4 4 4 4 4 4 4 4 4 4 4 1 0 0 0 0 0 0 0 0 0 0 0 0 0 0 0 0 0 0 0 0 0 0 0 0 0 0 0 0 1 4 4 4 4 4 4 4 4 1 4 4 4 4 4 4 4 4 4 4 4 4 4 4 4 1 0
0 1 4 4 4 1 4 4 4 4 4 4 4 4 4 4 4 1 0 0 0 0 0 0 0 0 0 0 0 0 0 0 0 0 0 0 0 0 0 0 0 0 1 1 1 1 1 4 4 4 4 4 4 4 4 1 4 4 4 4 4 4 4 4 4 4 4 4 4 4 4 1 0
0 1 4 4 4 1 4 4 4 4 4 4 4 4 4 4 4 1 0 0 0 0 0 0 0 0 0 0 0 0 0 0 0 0 0 0 0 0 0 0 0 0 1 4 4 4 4 4 4 4 4 4 4 4 4 1 1 3 1 1 4 4 4 4 4 4 4 4 4 4 4 1 0
0 1 4 4 4 1 4 4 4 4 4 4 4 4 4 4 4 1 0 0 0 0 0 0 0 0 0 0 0 0 0 0 0 0 0 0 0 0 0 0 0 0 1 4 4 4 4 4 6 4 4 4 4 4 4 4 4 4 4 1 4 4 4 4 4 4 4 4 4 4 4 1 0
0 1 4 4 4 3 4 4 4 4 4 4 4 4 4 4 4 1 0 0 0 0 0 0 0 0 0 0 0 0 0 0 0 0 0 0 0 0 0 0 0 0 1 4 4 4 4 4 6 4 4 4 4 4 4 4 4 4 4 1 4 4 4 4 4 4 4 4 4 4 4 1 0
0 1 4 4 4 1 4 4 4 4 4 4 4 4 4 4 4 1 0 0 0 0 0 0 0 0 0 0 0 0 0 0 0 0 0 0 0 0 0 0 0 0 1 4 4 4 1 1 1 1 1 1 1 4 4 4 4 4 4 1 4 4 4 4 4 4 4 4 4 4 4 1 0
0 1 4 4 4 1 4 4 4 4 4 4 4 4 4 4 4 1 0 0 0 0 0 0 0 0 0 0 0 0 0 0 0 0 0 0 0 0 0 0 0 0 1 4 4 4 1 4 4 4 4 4 1 4 4 1 1 3 1 1 4 4 4 4 4 4 4 4 4 4 4 1 0
0 1 4 4 4 1 1 1 1 1 1 1 1 1 1 1 1 1 0 0 0 0 0 0 0 0 0 1 1 1 1 1 1 1 1 1 1 0 0 0 0 0 1 4 4 4 3 4 4 4 4 4 1 4 4 1 4 4 4 4 4 4 4 4 4 4 4 4 4 4 4 1 0
0 1 4 4 4 1 4 4 4 4 4 4 4 4 4 4 4 1 0 0 0 0 0 0 0 0 0 1 4 4 4 4 4 4 4 4 1 0 0 0 0 0 1 4 4 4 1 4 4 4 4 4 1 4 4 1 4 4 4 4 4 4 4 4 4 4 4 4 4 4 4 1 0
0 1 4 4 4 1 4 4 4 4 4 4 4 4 4 4 4 1 0 0 0 0 0 0 0 0 0 1 4 4 4 4 4 4 4 4 1 0 0 0 0 0 1 4 4 4 1 1 1 1 1 1 1 4 4 1 4 4 4 4 4 4 4 4 4 4 4 4 4 4 4 1 0
0 1 4 4 4 1 4 4 4 4 4 4 4 4 4 4 4 1 0 0 0 0 0 0 0 0 0 1 4 4 4 4 4 4 4 4 1 0 0 0 0 0 1 4 4 4 1 4 4 4 4 4 1 4 4 1 1 1 1 1 1 1 1 1 1 1 1 1 1 3 1 1 0
0 1 4 4 4 1 4 4 4 4 4 4 4 4 4 4 4 1 0 0 0 0 0 0 0 0 0 1 4 4 4 4 4 4 4 4 1 0 0 0 0 0 1 4 4 4 3 4 4 4 4 4 1 4 4 4 4 4 4 4 4 4 4 4 4 4 4 4 4 4 4 1 0
0 1 4 4 4 1 4 4 4 4 4 4 4 4 4 4 4 1 0 0 0 0 0 0 0 0 0 1 4 4 4 4 4 4 4 4 1 0 0 0 0 0 1 4 4 4 1 4 4 4 4 4 1 4 4 4 4 4 4 4 4 4 4 4 4 4 4 4 4 4 4 1 0
0 1 4 4 4 3 4 4 4 4 4 4 4 4 4 4 4 1 0 0 0 0 0 0 0 0 0 1 4 4 4 4 4 4 4 4 1 0 0 0 0 0 1 4 4 4 1 1 1 1 1 1 1 4 4 1 1 1 1 1 1 1 1 1 1 1 1 1 1 3 1 1 0
0 1 4 4 4 1 4 4 4 4 4 4 4 4 4 4 4 1 0 0 0 0 0 0 0 0 0 1 4 4 4 4 4 4 4 4 1 0 0 0 0 0 1 4 4 4 1 4 4 4 4 4 1 4 4 1 4 4 4 4 4 4 4 4 4 4 4 4 4 4 4 1 0
0 1 4 4 4 1 4 4 4 4 4 4 4 4 4 4 4 1 0 0 0 0 0 0 0 0 0 1 4 4 4 4 4 4 4 4 1 0 0 0 0 0 1 4 4 4 3 4 4 4 4 4 1 4 4 1 4 4 4 4 4 4 4 4 4 4 4 4 4 4 4 1 0
0 1 4 4 4 1 1 1 1 1 1 1 1 1 1 1 1 1 0 0 0 0 0 0 0 0 0 1 4 4 4 4 4 4 4 4 1 0 0 0 0 0 1 4 4 4 1 4 4 4 4 4 1 4 4 1 4 4 4 4 4 4 4 4 4 4 4 4 4 4 4 1 0
0 1 4 4 4 1 4 4 4 4 4 4 4 4 4 4 4 1 0 0 0 0 1 1 1 1 1 1 1 3 1 1 1 1 1 1 1 0 0 0 0 0 1 4 4 4 1 1 1 1 1 1 1 4 4 1 1 3 1 1 4 4 4 4 4 4 4 4 4 4 4 1 0
0 1 4 4 4 1 4 4 4 4 4 4 4 4 4 4 4 1 0 0 0 0 1 4 4 4 4 4 4 4 4 1 4 4 4 4 1 0 0 0 0 0 1 4 4 4 1 4 4 4 4 4 1 4 4 4 4 4 4 1 4 4 4 4 4 4 4 4 4 4 4 1 0
0 1 4 4 4 1 4 4 4 4 4 4 4 4 4 4 4 1 0 0 0 0 1 4 4 4 4 4 4 4 4 3 4 4 4 4 1 0 0 0 0 0 1 4 4 4 3 4 4 4 4 4 1 4 4 4 4 4 4 1 4 4 4 4 4 4 4 4 4 4 4 1 0
0 1 4 4 4 1 4 4 4 4 4 4 4 4 4 4 4 1 0 0 0 0 1 4 4 4 4 4 4 4 4 1 4 4 4 4 1 0 0 0 0 0 1 4 4 4 1 4 4 4 4 4 1 4 4 4 4 4 4 1 4 4 4 4 4 4 4 4 4 4 4 1 0
0 1 4 4 4 1 4 4 4 4 4 4 4 4 4 4 4 1 0 0 0 0 1 4 4 4 4 4 4 4 4 1 4 4 4 4 1 0 0 0 0 0 1 4 4 4 1 1 1 1 1 1 1 4 4 1 1 3 1 1 4 4 4 4 4 4 4 4 4 4 4 1 0
0 1 4 4 4 3 4 4 4 4 4 4 4 4 4 4 4 1 0 0 0 0 1 1 1 1 1 1 4 4 4 1 1 1 1 1 1 0 0 0 0 0 1 4 4 4 4 4 4 4 4 4 1 4 4 1 4 4 4 4 4 4 4 4 4 4 4 4 4 4 4 1 0
0 1 4 4 4 1 4 4 4 4 4 4 4 4 4 4 4 1 0 0 0 0 1 4 4 4 4 1 4 4 4 1 4 4 4 4 1 0 0 0 0 0 1 4 4 4 4 4 4 4 4 4 1 4 4 1 4 4 4 4 4 4 4 4 4 4 4 4 4 4 4 1 0
0 1 4 4 4 1 4 4 4 4 4 4 4 4 4 4 4 1 0 0 0 0 1 4 4 4 4 3 4 4 4 3 4 4 4 4 1 0 0 0 0 0 1 4 4 4 4 4 4 4 4 4 1 4 4 1 4 4 4 4 4 4 4 4 4 4 4 4 4 4 4 1 0
0 1 4 4 4 1 1 1 1 1 1 1 1 1 1 1 1 1 0 0 0 0 1 4 4 4 4 1 4 4 4 1 4 4 4 4 1 0 0 0 0 0 1 4 4 4 4 4 4 4 4 4 1 4 4 1 1 1 1 1 1 1 1 1 1 1 1 1 1 3 1 1 0
0 1 4 4 4 1 4 4 4 4 4 4 4 4 4 4 4 1 0 0 0 0 1 4 4 4 4 1 4 4 4 1 4 4 4 4 1 0 0 0 0 0 1 4 4 4 4 4 4 4 4 4 1 4 4 4 4 4 4 4 4 4 4 4 4 4 4 4 4 4 4 1 0
0 1 4 4 4 1 4 4 4 4 4 4 4 4 4 4 4 1 0 0 0 0 1 1 1 1 1 1 4 4 4 1 1 1 1 1 1 0 0 0 0 0 1 4 4 4 4 4 4 4 4 4 1 4 4 4 4 4 4 4 4 4 4 4 4 4 4 4 4 4 4 1 0
0 1 4 4 4 1 4 4 4 4 4 4 4 4 4 4 4 1 0 0 0 0 1 4 4 4 4 1 4 4 4 1 4 4 4 4 1 0 0 0 0 0 1 4 4 4 4 4 4 4 4 4 1 4 4 1 1 1 1 1 1 1 1 1 1 1 1 1 1 3 1 1 0
0 1 4 4 4 1 4 4 4 4 4 4 4 4 4 4 4 1 0 0 0 0 1 4 4 4 4 3 4 4 4 3 4 4 4 4 1 0 0 0 0 0 1 4 4 4 4 4 4 4 4 4 1 4 4 1 4 4 4 4 4 4 4 4 4 4 4 4 4 4 4 1 0
0 1 4 4 4 1 4 4 4 4 4 4 4 4 4 4 4 1 0 0 0 0 1 4 4 4 4 1 4 4 4 1 4 4 4 4 1 0 0 0 0 0 1 4 4 4 4 4 4 4 4 4 1 4 4 1 4 4 4 4 4 4 4 4 4 4 4 4 4 4 4 1 0
0 1 4 4 4 3 4 4 4 4 4 4 4 4 4 4 4 1 0 0 0 0 1 4 4 4 4 1 4 4 4 1 4 4 4 4 1 0 0 0 0 0 1 4 4 4 4 4 4 4 4 4 1 4 4 1 4 4 4 4 4 4 4 4 4 4 4 4 4 4 4 1 0
0 1 4 4 4 1 4 4 4 4 4 4 4 4 4 4 4 1 0 0 0 0 1 1 1 1 1 1 4 4 4 1 1 1 1 1 1 0 0 0 0 0 1 4 4 4 4 4 4 4 4 4 1 4 4 1 1 3 1 1 4 4 4 4 4 4 4 4 4 4 4 1 0
0 1 4 4 4 1 4 4 4 4 4 4 4 4 4 4 4 1 0 0 0 0 1 4 4 4 4 1 4 4 4 1 4 4 4 4 1 0 0 0 0 0 1 4 4 4 4 4 4 4 4 4 1 4 4 4 4 4 4 1 4 4 4 4 4 4 4 4 4 4 4 1 0
0 1 4 4 4 1 1 1 1 1 1 1 1 1 1 1 1 1 0 0 0 0 1 4 4 4 4 3 4 4 4 3 4 4 4 4 1 0 0 0 0 0 1 4 4 4 4 4 4 4 4 4 1 4 4 4 4 4 4 1 4 4 4 4 4 4 4 4 4 4 4 1 0
0 1 4 4 4 4 4 4 4 4 4 4 4 4 4 4 4 1 0 0 0 0 1 4 4 4 4 1 4 4 4 1 4 4 4 4 1 0 0 0 0 0 1 4 4 4 4 4 4 4 4 4 1 4 4 4 4 4 4 1 4 4 4 4 4 4 4 4 4 4 4 1 0
0 1 4 4 4 4 4 4 4 4 4 4 4 4 4 4 4 1 0 0 0 0 1 4 4 4 4 1 4 4 4 1 4 4 4 4 1 0 0 0 0 0 1 4 4 4 4 4 4 4 4 4 4 4 4 1 1 3 1 1 4 4 4 4 4 4 4 4 4 4 4 1 0
0 1 4 4 4 4 4 4 4 4 4 6 4 4 4 4 4 1 1 1 1 1 1 1 1 1 1 1 1 3 1 1 1 1 1 1 1 1 1 1 1 1 1 4 4 4 4 4 4 4 4 4 4 4 4 1 4 4 4 4 4 4 4 4 4 4 4 4 4 4 4 1 0
0 1 4 4 4 4 4 4 4 4 4 6 4 4 4 4 4 4 4 4 4 4 4 4 4 4 4 4 4 4 4 4 4 4 4 4 4 4 4 4 4 4 4 4 4 4 4 4 4 4 4 4 4 4 4 1 4 4 4 4 4 4 4 4 4 4 4 4 4 4 4 1 0
0 1 4 4 4 4 4 4 4 4 4 4 4 4 4 4 4 4 4 4 4 4 4 4 4 4 4 4 4 4 4 4 4 4 4 4 4 4 4 4 4 4 4 4 4 4 4 1 1 1 1 1 4 4 4 1 4 4 4 4 4 4 4 4 4 4 4 4 4 4 4 1 0
0 1 4 4 4 4 4 4 4 4 4 4 4 4 4 4 4 4 4 4 4 4 4 4 4 4 4 4 4 4 4 4 4 4 4 4 4 4 4 4 4 4 4 4 4 4 4 1 4 4 4 1 4 4 4 1 1 1 1 1 1 1 1 1 1 1 1 1 1 1 1 1 0
0 1 4 4 4 4 4 4 4 4 4 4 4 4 4 4 4 1 1 1 1 1 1 1 1 1 1 1 1 1 1 1 1 1 1 1 1 1 1 1 1 1 1 4 4 4 2 1 4 4 4 4 4 4 4 1 0 0 0 0 0 0 0 0 0 0 0 0 0 0 0 0 0
0 1 1 1 3 1 1 1 1 1 1 1 1 1 1 3 1 1 0 0 0 0 0 0 0 0 0 0 0 0 0 0 0 0 0 0 0 0 0 0 0 0 1 1 3 1 1 1 1 1 1 1 1 3 1 1 0 0 0 0 0 0 0 0 0 0 0 0 0 0 0 0 0
0 1 4 4 4 4 4 4 4 1 4 4 4 4 4 4 4 1 0 0 0 0 0 0 0 0 0 0 0 0 0 0 0 0 0 0 0 0 0 0 0 0 1 4 4 4 4 4 4 1 4 4 4 4 4 1 0 0 0 0 0 0 0 0 0 0 0 0 0 0 0 0 0
0 1 4 4 4 4 4 4 4 1 4 4 4 4 4 4 4 1 0 0 0 0 0 0 0 0 0 0 0 0 0 0 0 0 0 0 0 0 0 0 0 0 1 4 4 4 4 4 4 1 4 4 4 4 4 1 0 0 0 0 0 0 0 0 0 0 0 0 0 0 0 0 0
0 1 4 4 4 4 4 4 4 1 4 4 4 4 4 4 4 1 0 0 0 0 0 0 0 0 0 0 0 0 0 0 0 0 0 0 0 0 0 0 0 0 1 4 4 4 4 4 4 1 4 4 4 4 4 1 0 0 0 0 0 0 0 0 0 0 0 0 0 0 0 0 0
0 1 1 1 1 1 1 1 1 1 1 1 1 1 1 1 1 1 0 0 0 0 0 0 0 0 0 0 0 0 0 0 0 0 0 0 0 0 0 0 0 0 1 1 1 1 1 1 1 1 1 1 1 1 1 1 0 0 0 0 0 0 0 0 0 0 0 0 0 0 0 0 0
0 0 0 0 0 0 0 0 0 0 0 0 0 0 0 0 0 0 0 0 0 0 0 0 0 0 0 0 0 0 0 0 0 0 0 0 0 0 0 0 0 0 0 0 0 0 0 0 0 0 0 0 0 0 0 0 0 0 0 0 0 0 0 0 0 0 0 0 0 0 0 0 0